##########
#S..L...E#
#.##T##..#
#H....A..#
##########